14
13
w
1011111111111
1010100000001
1010101101101
1000100100111
1011101110001
1000001011111
1111101010001
1000001010101
1010100010101
1010111110101
1010000000101
1010101111101
1010100000103
1111111111111
