16
20
10111111111111110111
10100010001010110001
10001010100010001101
11111010101011101101
10000010101000101001
11101110101010101011
10000000111010101001
10111111101010101011
10100000001010101011
10111110111110101011
10100000100010001001
10111010101000101101
10100010101011000001
10101110101111011101
10000010100000010101
11111111111111111111
