30
30
v
101111111111111111111111111111
100010001000000000000000000001
101110111110111111111101101111
100000000010000000100101000001
101111111011111110101111111101
101000000000000010101000000001
101111111101111110101110111101
100000100000000000100000100001
111110101110111111101111101111
100000101000010000001000001001
101111101011110111111011111101
100000101010100000001000000001
111110101010111111101111110101
100000001010000100000000010101
101111111010111111101111011101
101000000010000000101000010001
101110111111111110101011010101
100010100000010000101001010101
101110101111010111101011011101
101000100010010100101010010001
101110101110110110001010010111
100000101000100011111111010001
101111101010101000000001011101
101000001110111111111011000111
101110100010000100001010010000
100010111011110101101011110111
101110001010100000101000010101
101011111010111110101101011101
100000000010000000100001000001
111111111111111111111111111111
