15
15
r
101111111111111
101000000000001
101011111111101
101010000010001
101010111000101
101010001111101
101011100000001
101000111110101
100010010000101
101010111010111
101111101010001
101000000010101
101011111011101
101001000000001
111101111111111
